■■■■■■■■■■■■■■■■■■■■■■■■■■■■■■■■■■■■■■■■
■■■■■■■■■■■■■■■■■■■■■■■■■■■■■■■■■■■■■■■■
■■■■■■■■■■■■■■■■■■■■■■■■■■■■■■■■■■■■■■■■
■■■■■■■■■■■■■■■■■■■■■■■■■■■■■■■■■■■■■■■■
■■■■■■■■■■■■■■■■■■■■■■■■■■■■■■■■■■■■■■■■
■■■■■■■■■■■■■■■■■■■■■■■■■■■■■■■■■■■■■■■■
■■■■■■■■■■■■■■■■■■■■■■■■■■■■■■■■■■■■■■■■
■■■■■■■■■■■■■■■■■■■■■■■■■■■■■■■■■■■■■■■■
■■■■■■■■■■■■■■■■■■■■■■■■■■■■■■■■■■■■■■■■
■■■■■■■■■■■■■■■■■■■　■■■■■■■■■■■■■■■■■■■■
■■■■■　　　　　　■■■■■■■　　　■■■■■■■　　　　　　■■■■■■
■■■■■　　　　　　☆　　　　　　　　　　　　　　　☆　　　　　　■■■■■■
■■■■■　　　　　　■■　　水　　　　　　　水　　■■　　　　　　■■■■■■
■■■■■■■■■■■■■■　　水　　　　　水　　■■■■■■■■■■■■■■■
■■■■■■■■■■■■■■■　　　　　　　　　■■■■■■■■■■■■■■■■
■■■■■■■■■■■■■■■■　　壁壁壁　　■■■■■■■■■■■■■■■■■
■■■■■■■■■■■■■■■　　　　　　　　　■■■■■■■■■■■■■■■■
■■■■■■■■■■■■■■　　　　水　水　　　　■■■■■■■■■■■■■■■
■■■■■　　　　　　■■　　　■■■　■■■　　　■■　　　　　　■■■■■■
■■■■■　　　　　　☆　　水■■■■　■■■■水　　☆　　　　　　■■■■■■
■■■■■　　　　　　■■☆■■■■■☆■■■■■☆■■　　　　　　■■■■■■
■■■■■■■■■■■■　　　■■■　　　■■■　　　■■■■■■■■■■■■■
■■■■■■■■■■■■　　　■■■　　　■■■　　　■■■■■■■■■■■■■
■■■■■■■■■■■■　　　■■■　　　■■■　　　■■■■■■■■■■■■■
■■■■■■■■■■■■　　　■■■　　　■■■　　　■■■■■■■■■■■■■
■■■■■■■■■■■■　　　■■■　　　■■■　　　■■■■■■■■■■■■■
■■■■■■■■■■■■　　　■■■　　　■■■　　　■■■■■■■■■■■■■
■■■■■■■■■■■■■■■■■■■■■■■■■■■■■■■■■■■■■■■■
■■■■■■■■■■■■■■■■■■■■■■■■■■■■■■■■■■■■■■■■
■■■■■■■■■■■■■■■■■■■■■■■■■■■■■■■■■■■■■■■■