■■■■■■■■■■■■■■■■■■■■■■■■■■■■■■■■■■■■■■■■
■■■■■■■■■■■■■■■■■■■■■■■■■■■■■■■■■■■■■■■■
■■■■■■■■■■■■■■■■■■■■■■■■■■■■■■■■■■■■■■■■
■■■■■■■■■■■■■■■■■■■■■■■■■■■■■■■■■■■■■■■■
■■■■■■■■■■■■■■■■■■■■■■■■■■■■■■■■■■■■■■■■
■■■■■■■■■■■■■■■■■■■■■■■■■■■■■■■■■■■■■■■■
■■■■■■■■■■■■■■■■■■■■■■■■■■■■■■■■■■■■■■■■
■■■■■■■■■■■■■■■■■■■■■■■■■■■■■■■■■■■■■■■■
■■■■■■■■■■■■■■■■■■■■■■■■■■■■■■■■■■■■■■■■
■■■■■■■■■■■■壁　　　　　　　　　　　　　壁■■■■■■■■■■■■■
■■■■■■■■■■■■　　壁　　　　　　　　壁壁　　■■■■■■■■■■■■■
■■■■■■■■■■■■　　壁　　　　水　　　　　　　■■■■■■■■■■■■■
■■■■■■■■■■■■　　　　　　水　水　　　　　　■■■■■■■■■■■■■
■■■■■■■■■■■■　　水　水　　　　　水　水　　■■■■■■■■■■■■■
■■■■■■■■■■■■　　　水　　　水　　　水　　　■■■■■■■■■■■■■
■■■■■■■■■■■■　　　　　　水壁水　　　　　　■■■■■■■■■■■■■
■■■■■■■■■■■■　　　水　　　水　　　水　　　■■■■■■■■■■■■■
■■■■■■■■■■■■　　水　水　　　　　水　水　　■■■■■■■■■■■■■
■■■■■■■■■■■■　　　　　　水　水　　　　　　■■■■■■■■■■■■■
■■■■■■■■■■■■　　　　　　　水　　　　壁　　■■■■■■■■■■■■■
■■■■■■■■■■■■　　壁壁　　　　　　　　壁　　■■■■■■■■■■■■■
■■■■■■■■■■■■壁　　　　　　　　　　　　　壁■■■■■■■■■■■■■
■■■■■■■■■■■■■■■■■■■■■■■■■■■■■■■■■■■■■■■■
■■■■■■■■■■■■■■■■■■■■■■■■■■■■■■■■■■■■■■■■
■■■■■■■■■■■■■■■■■■■■■■■■■■■■■■■■■■■■■■■■
■■■■■■■■■■■■■■■■■■■■■■■■■■■■■■■■■■■■■■■■
■■■■■■■■■■■■■■■■■■■■■■■■■■■■■■■■■■■■■■■■
■■■■■■■■■■■■■■■■■■■■■■■■■■■■■■■■■■■■■■■■
■■■■■■■■■■■■■■■■■■■■■■■■■■■■■■■■■■■■■■■■
■■■■■■■■■■■■■■■■■■■■■■■■■■■■■■■■■■■■■■■■