■■■■■■■■■■■■■■■■■■■■■■■■■■■■■■■■■■■■■■■■
■■■■■■■■■■■■■■■■■■■■■■■■■■■■■■■■■■■■■■■■
■■■■■■■■■■■■■■■■■■■■■■■■■■■■■■■■■■■■■■■■
■■■■■■■■■■■■■■■■■■■■■■■■■■■■■■■■■■■■■■■■
■■■■■■■■■■■■■■■■■■■■■■■■■■■■■■■■■■■■■■■■
■■■■■■■■■■■■■■■■■　　　　　　■■■■■■■■■■■■■■■■■
■■■■■■■■■■■■■　　　　　　　　　　　　　　■■■■■■■■■■■■■
■■■■■■■■■■　　　　　■　　■■■■　　■　　　　　■■■■■■■■■■
■■■■■■■　　　　■　　■■　　　　　　　　■■　　■　　　　■■■■■■■
■■■■■■　　　■　　　　　　　　　　　　　　　　　　　　■　　　■■■■■■
■■■■■■　■　　　　■　　　　■　　　　■　　　　■　　　　■　■■■■■■
■■■■■　　　　　■　　　　　　　　　　■　　　　　　　■　　　　　■■■■■
■■■■■　　■　　　　■■　　　　■■　　　　■■　　　　　　■　　■■■■■
■■■■■　　■　　　　　　■■　　　　■■　　　　■■　　　　■　　■■■■■
■■■■■　　　　　■　　　　　　　■　　　　　　　　　　■　　　　　■■■■■
■■■■■■　■　　　■■　　　　■　　　　■　　　　■■　　　■　■■■■■■
■■■■■■　　　■　　　　■　　　　　　　　　　■　　　　■　　　■■■■■■
■■■■■■■　　　　■　　■■　　　　　　　　■■　　■　　　　■■■■■■■
■■■■■■■■■■　　　　■　　　■■■■　　　■　　　　■■■■■■■■■■
■■■■■■■■■■■■■　　　　　　　　　　　　　　■■■■■■■■■■■■■
■■■■■■■■■■■■■■■■■　　　　　　■■■■■■■■■■■■■■■■■
■■■■■■■■■■■■■■■■■■■■■■■■■■■■■■■■■■■■■■■■
■■■■■■■■■■■■■■■■■■■■■■■■■■■■■■■■■■■■■■■■
■■■■■■■■■■■■■■■■■■■■■■■■■■■■■■■■■■■■■■■■
■■■■■■■■■■■■■■■■■■■■■■■■■■■■■■■■■■■■■■■■
■■■■■■■■■■■■■■■■■■■■■■■■■■■■■■■■■■■■■■■■