■■■■■■■■■■■■■■■■■■■■■■■■■■■■■■■■■■■■■■■■
■■　　　　　　■■■■■■■■■■■■■■■■■■■■■■■■　　　　　　■■
■■　　　　　　■■■■■■■■■■■■■■■■■■■■■■■■　　　　　　■■
■■　　　　　　■■■■■■■■■■■■■■■■■■■■■■■■　　　　　　■■
■■　　　　　　■■■■■■■■■■■■■■■■■■■■■■■■　　　　　　■■
■■　　　　　　■■■■■■■■■■■■■■■■■■■■■■■■　　　　　　■■
■■　　　　　　■■■■■■■■■■■■■■■■■■■■■■■■　　　　　　■■
■■■■■■■■■■■■■■■■■■■■■■■■■■■■■■■■■■■■■■■■
■■■■■■■■■■■■■■■■■■■■■■■■■■■■■■■■■■■■■■■■
■■■■■■■■■■■■■■■■■■■■■■■■■■■■■■■■■■■■■■■■
■■■■■■■■■■■■■■■■■■　　　■■■■■■■■■■■■■■■■■■■
■■■■■■■■■■■■■■■■　　　　　　　■■■■■■■■■■■■■■■■■
■■■■■■■■■■■■■■■■　　　　　　　■■■■■■■■■■■■■■■■■
■■■■■■■■■■■■■■■　　　　　　　　　■■■■■■■■■■■■■■■■
■■■■■■■■■■■■■■■　　　　　　　　　■■■■■■■■■■■■■■■■
■■■■■■■■■■■■■■■　　　　　　　　　■■■■■■■■■■■■■■■■
■■■■■■■■■■■■■■■■　　　　　　　■■■■■■■■■■■■■■■■■
■■■■■■■■■■■■■■■■　　　　　　　■■■■■■■■■■■■■■■■■
■■■■■■■■■■■■■■■■■■　　　■■■■■■■■■■■■■■■■■■■
■■■■■■■■■■■■■■■■■■■■■■■■■■■■■■■■■■■■■■■■
■■■■■■■■■■■■■■■■■■■■■■■■■■■■■■■■■■■■■■■■
■■■■■■■■■■■■■■■■■■■■■■■■■■■■■■■■■■■■■■■■
■■■■■■■■■■■■■■■■■■■■■■■■■■■■■■■■■■■■■■■■
■■　　　　　　■■■■■■■■■■■■■■■■■■■■■■■■　　　　　　■■
■■　　　　　　■■■■■■■■■■■■■■■■■■■■■■■■　　　　　　■■
■■　　　　　　■■■■■■■■■■■■■■■■■■■■■■■■　　　　　　■■
■■　　　　　　■■■■■■■■■■■■■■■■■■■■■■■■　　　　　　■■
■■　　　　　　■■■■■■■■■■■■■■■■■■■■■■■■　　　　　　■■
■■　　　　　　■■■■■■■■■■■■■■■■■■■■■■■■　　　　　　■■
■■■■■■■■■■■■■■■■■■■■■■■■■■■■■■■■■■■■■■■■