##################
#******###########
#******..........#
#******###.#####.#
#******###.#####.#
#******##****###.#
####.####****###.#
####.....****###.#
####.####****###.#
####.####****###.#
####....##.#####.#
#....##..........#
#.#############.##
#.#############.##
#.####***********#
#.####***********#
#.#...***********#
#.#.##***********#
#.....***********#
######***********#
##################
##################
