##################
#***##############
#***##############
#***##############
##################
##################
##.............###
##.###########.###
##.###########.###
##.###########.###
##.###########.###
##.###########.###
##.###########.###
##.###########.###
##.###########.###
##.###########.###
##.###########.###
##.............###
##################
##################
##################
