壁壁壁壁壁壁壁壁壁壁壁壁壁壁壁壁壁壁壁壁壁壁壁壁壁壁壁壁壁壁壁壁壁壁壁壁壁壁壁壁
壁壁壁壁壁壁壁壁壁壁壁壁壁壁壁壁壁壁壁壁壁壁壁壁壁壁壁壁壁壁壁壁壁壁壁壁壁壁壁壁
壁壁壁壁壁壁壁壁壁壁壁壁壁壁壁壁壁壁壁壁壁壁壁壁壁壁壁壁壁壁壁壁壁壁壁壁壁壁壁壁
壁壁壁壁壁壁壁壁壁壁壁壁壁壁壁壁壁壁壁壁壁壁壁壁壁壁壁壁　　　　　　壁壁壁壁壁壁
壁壁壁壁壁壁壁壁壁壁壁壁壁壁☆☆☆☆☆☆☆☆☆☆☆☆☆☆　　　　　　壁壁壁壁壁壁
壁壁壁壁壁壁壁壁壁壁壁壁壁壁☆壁壁壁壁壁壁壁壁壁壁壁壁壁　　　　　　壁壁壁壁壁壁
壁壁壁壁壁壁壁壁壁壁壁壁壁壁☆壁壁壁壁壁壁壁壁壁壁壁壁壁　　　　　　壁壁壁壁壁壁
壁壁壁壁壁壁壁壁壁壁壁壁壁壁☆壁壁壁壁壁壁壁壁壁壁壁壁壁　　　　　　壁壁壁壁壁壁
壁壁壁壁壁壁壁壁壁壁壁壁壁壁☆壁壁壁壁壁壁壁壁壁壁壁壁壁壁☆壁壁壁壁壁壁壁壁壁壁
壁壁壁壁壁壁壁壁壁壁壁壁壁壁☆壁壁壁☆☆☆☆☆☆☆☆☆☆☆☆壁壁壁壁壁壁壁壁壁壁
壁壁壁壁壁壁壁壁壁壁壁壁壁壁☆壁壁壁☆壁壁壁壁壁壁壁壁壁壁壁壁壁壁壁壁壁壁壁壁壁
壁壁壁壁壁壁壁壁壁壁壁壁壁壁☆壁壁壁☆壁壁壁壁壁壁壁壁壁壁壁壁壁壁壁壁壁壁壁壁壁
壁壁壁壁壁壁壁壁壁壁壁壁壁壁☆壁壁壁☆壁壁壁壁壁壁壁壁壁壁壁壁壁壁壁壁壁壁壁壁壁
壁壁壁　　　　　　　　壁壁壁☆壁壁壁☆壁壁壁壁　　　　　壁壁壁壁壁壁壁壁壁壁壁壁
壁壁壁　　　　　　　　壁壁壁☆壁壁壁☆壁壁壁壁　　　　　壁壁壁壁壁壁壁壁壁壁壁壁
壁壁壁　　　　　　　　壁壁壁☆壁壁壁☆壁壁壁壁　　　　　壁壁壁壁　　　　　　壁壁
壁壁壁　　　　　　　　壁壁壁☆壁壁壁☆壁壁壁壁　　　　　壁壁壁壁　　　　　　壁壁
壁壁壁　　　　　　　　壁壁壁☆壁壁壁☆壁壁壁壁　　　　　壁壁☆☆　　　　　　壁壁
壁壁壁　　　　　　　　☆☆☆☆壁壁壁☆壁壁壁壁　　　　　壁壁☆壁　　　　　　壁壁
壁壁壁　　　　　　　　壁壁壁☆壁壁壁☆壁壁壁壁　　　　　☆☆☆壁　　　　　　壁壁
壁壁壁　　　　　　　　壁壁壁☆壁壁壁☆壁壁壁壁　　　　　壁壁壁壁　　　　　　壁壁
壁壁壁　　　　　　　　壁壁壁☆壁壁壁☆壁壁壁壁壁壁壁壁壁壁壁壁壁壁☆壁壁壁壁壁壁
壁壁壁　　　　　　　　壁壁壁☆壁　　　　壁壁壁壁壁壁壁壁壁壁壁壁☆☆壁壁壁壁壁壁
壁壁壁　　　　　　　　壁壁壁☆壁　　　　壁壁壁壁壁壁壁壁壁壁壁壁☆壁壁壁壁壁壁壁
壁壁壁壁壁壁壁壁壁壁壁壁壁壁☆壁　　　　☆☆壁壁壁壁壁壁壁　　　　　壁壁壁壁壁壁
壁壁壁壁壁壁壁壁壁壁壁壁壁壁☆☆　　　　壁☆壁壁壁壁壁壁壁　　　　　壁壁壁壁壁壁
壁壁壁壁壁壁壁壁壁壁壁壁壁壁壁壁　　　　壁☆☆☆☆☆☆☆☆　　　　　壁壁壁壁壁壁
壁壁壁壁壁壁壁壁壁壁壁壁壁壁壁壁壁壁壁壁壁壁壁壁壁壁壁壁壁　　　　　壁壁壁壁壁壁
壁壁壁壁壁壁壁壁壁壁壁壁壁壁壁壁壁壁壁壁壁壁壁壁壁壁壁壁壁　　　　　壁壁壁壁壁壁
壁壁壁壁壁壁壁壁壁壁壁壁壁壁壁壁壁壁壁壁壁壁壁壁壁壁壁壁壁壁壁壁壁壁壁壁壁壁壁壁
