壁壁壁壁壁壁壁壁壁壁壁壁壁壁壁壁壁壁壁壁壁壁壁壁壁壁壁壁壁壁壁壁壁壁壁壁壁壁壁壁
壁壁壁壁壁壁壁壁壁壁壁壁壁壁壁壁壁　壁壁壁壁壁壁壁壁壁壁壁　壁壁壁壁壁壁壁壁壁壁
壁壁壁壁壁壁壁壁壁壁壁壁壁壁壁壁壁　壁壁壁壁壁壁壁壁壁壁壁　壁壁壁壁壁壁壁壁壁壁
壁壁壁壁壁壁壁壁壁壁壁壁壁壁壁壁壁　壁壁壁壁壁壁水水水壁壁　壁壁壁壁壁壁壁壁壁壁
壁壁壁壁壁壁壁壁壁水水壁水水水壁　　　　　　　　　　　　　　　壁壁壁壁壁壁壁壁壁
壁壁壁壁壁壁壁壁壁壁水水水　水壁　　　　　　　　　　　　　　　壁壁壁壁壁壁壁壁壁
壁壁壁壁壁壁壁　　　　　　　水壁　　　　　　　　　　　　　　　壁壁壁壁壁壁壁壁壁
壁壁壁壁壁壁壁壁壁壁水水水　水壁　　　　　　　　　　　　　　　水壁壁壁壁壁壁壁壁
壁壁壁壁壁壁壁壁壁壁壁水水　　　　　　　　　　　　　　　　　　水壁壁壁壁壁壁壁壁
壁壁壁壁壁壁壁壁壁壁水水水壁壁壁　　　　　　　　　　　　　　　水壁壁壁壁壁壁壁壁
壁壁壁壁壁壁壁壁壁壁水水水壁壁壁　　　　　　　　　　　　　　　水壁壁壁壁壁壁壁壁
壁壁壁壁壁壁壁壁壁壁壁水水水壁壁　　　　　　　　　　　　　　　壁壁壁壁壁壁壁壁壁
壁壁壁壁壁壁壁壁壁壁壁壁水水水壁　　　　　　　　　　　　　　　　　　壁壁壁壁壁壁
壁壁壁壁壁壁壁壁壁壁壁壁壁水水壁　　　　　　　　　　　　　　　壁壁壁壁壁壁壁壁壁
壁壁壁壁壁壁壁壁壁壁壁壁壁壁水壁　　　　　　　　　　　　　　　壁壁壁壁壁壁壁壁壁
壁壁壁壁壁壁壁壁壁壁壁壁壁壁壁壁壁壁壁壁水水壁壁壁壁壁壁壁壁壁壁壁壁壁壁壁壁壁壁
壁壁壁壁壁壁壁壁壁壁壁壁壁壁壁壁壁壁壁水水水水壁壁壁壁壁壁壁壁壁壁壁壁壁壁壁壁壁
壁壁壁壁壁壁壁壁壁壁壁壁壁壁壁壁壁壁水水水水水水壁壁壁壁壁壁壁壁壁壁壁壁壁壁壁壁
壁壁壁壁■壁■壁壁壁壁壁壁壁壁壁水水水水水水水水水壁壁壁壁壁壁壁壁壁壁壁壁壁壁壁
壁壁壁壁■壁■壁壁壁壁壁壁壁壁壁水水水水水水水水水水壁壁壁壁壁壁壁壁壁壁壁壁壁壁
壁壁壁壁■壁■壁壁壁壁壁壁壁壁壁壁水水水水水水水水水壁壁壁壁壁壁壁壁壁壁壁壁壁壁
壁壁壁壁■壁■壁壁壁壁壁壁壁壁壁壁壁壁水水水水水水水水壁壁壁壁壁壁壁壁壁壁壁壁壁
壁壁壁壁■壁■壁壁壁壁壁壁壁壁壁壁壁水水壁水水壁壁壁壁壁壁壁壁壁壁壁壁壁壁壁壁壁
壁壁壁壁■壁■壁壁壁壁壁壁壁壁壁壁壁壁壁壁壁壁壁壁壁壁壁壁壁壁壁壁壁壁壁壁壁壁壁
壁壁壁壁■壁■壁壁壁壁壁壁壁壁壁壁壁壁壁壁壁壁壁壁壁壁壁壁壁壁壁壁壁壁壁壁壁壁壁
壁壁壁壁■壁■壁壁壁壁壁壁壁壁壁壁壁壁壁壁壁壁壁壁壁壁壁壁壁壁壁壁壁壁壁壁壁壁壁
壁壁壁壁■壁■壁壁壁壁壁壁壁壁壁壁壁壁壁壁壁壁壁壁壁壁壁壁壁壁壁壁壁壁壁壁壁壁壁
壁壁壁壁■壁■壁壁壁壁壁壁壁壁壁壁壁壁壁壁壁壁壁壁壁壁壁壁壁壁壁壁壁壁壁壁壁壁壁
壁壁壁壁■壁■壁壁壁壁壁壁壁壁壁壁壁壁壁壁壁壁壁壁壁壁壁壁壁壁壁壁壁壁壁壁壁壁壁
壁壁壁壁■　■壁壁壁壁壁壁壁壁壁壁壁壁壁壁壁壁壁壁壁壁壁壁壁壁壁壁壁壁壁壁壁壁壁