##################
#****************#
#****************#
#****************#
#****************#
#****************#
#****************#
#****************#
#****************#
#****************#
#****************#
#****************#
#****************#
#############.####
######***********#
######***********#
###...***********#
###.##***********#
###...***********#
######***********#
##################
##################
