##################
#***##############
#***##############
#***##############
##################
##################
##.............###
##.####.######.###
##.####.######.###
##.####.######.###
##.####.######.###
##.####.######.###
##.####.######.###
##.####.######.###
##.####.######.###
##.####.######.###
##.####.######.###
##.............###
##################
##################
##################
